DIMENSIONS 10 20
HEIGHT 10
CELL 20

TEXTURES 9
1 base-wall.jpg
2 wall2.tif
3 wall3.tif
4 comic-wall.jpg
5 wall5.tif
6 wall6.tif
7 wall7.tif
8 monaLisa.tif
9 my_floor.jpg

FLOORPLAN
# +___+___+___+___+___+___+___+___+___+___+___+___+___+___+___+___
    1   2   1   2   1   2   1   2   1   0   0
  1   0   0   0   0   0   0   0   0   6   0  
    0   1   1   1   1   1   1   1   1   0   0
  7   1   0   0   0   0   0   0   0   6   0  
    0   0   0   1   0   1   0   1   0   0   0
  1   1   1   1   1   1   1   1   0   6   0  
    0   0   1   0   1   0   1   0   1   0   0
  7   1   0   0   0   0   0   0   0   6   0  
    0   1   2   1   2   0   2   1   2   0   0
  1   0   0   0   0   0   0   0   0   6   0  
    1   1   2   1   2   1   0   1   0   0   0
  7   0   0   0   0   0   1   1   0   6   0  
    0   1   8   1   8   0   1   0   4   0   0
  1   1   0   0   0   1   1   0   0   6   0  
    0   0   0   0   0   0   0   0   0   0   0
  7   1   0   0   0   1   0   0   0   6   0  
    0   0   0   0   0   0   0   0   0   0   0
  1   0   0   0   0   1   1   0   0   6   0  
    1   1   1   0   1   0   1   0   1   0   0
  7   0   0   0   1   0   0   0   0   6   0  
    0   0   0   0   0   1   1   8   0   0   0
  1   0   0   0   1   1   0   0   0   6   0  
    1   1   0   1   0   0   0   0   0   0   0
  7   0   0   0   1   1   1   4   4   6   0  
    0   0   0   0   0   0   0   0   0   0   0
  1   0   1   0   1   1   1   4   4   6   0  
    1   3   0   3   0   0   0   0   0   0   0
  7   0   0   0   0   1   1   4   4   6   0  
    1   3   1   3   1   0   0   0   0   0   0
  1   0   0   0   0   0   0   4   4   6   0  
    1   1   1   1   0   1   1   4   1   0   0
  1   0   0   0   0   0   0   0   0   6   0
    0   1   1   1   4   3   0   0   0   0   0
  1   0   0   0   0   0   3   4   4   6   0  
    0   7   7   6   6   0   0   0   0   0   0
  7   7   0   0   0   2   1   4   4   6   0  
    0   2   5   6   5   0   0   0   0   0   0
  1   0   0   0   0   0   0   4   4   6   0  
    1   1   1   1   1   1   1   0   1   0   0
  0   0   0   0   0   0   0   0   0   0   0  
